WE ./path_to_the_west_texture
NO ./path_to_the_north_texture
SO ./path_to_the_south_texture
EA ./path_to_the_east_texture

F 220,100,12
C 225,30,0

1111111111111111111111111
10000000011100000000000001
1011000001110000000000001
1001000000000000000000001
11111111101100000111000000001
100000000011000001110111111111111
11110111111111011100000010001
11110111111111011101010010001
11000000E10101011100000010001
10000000000000001100000010001
10000000000000001101010010011
1100000111010101111101111011111
11110111 1110101 101111010011
11111111 1111111 111111111111
