NO ./path_to_the_north_texture   
SO ./path_to_the_south_texture
WE ./path_to_the_west_texture 
EA ./path_to_the_east_texture

F 222,100,0
C 225,30,25

111111111111111111111111
100001 100110000000000001
101101 101110000000000001
100101 100000000000000001
1111111110110000011100001
1000000000110000111111111
1111011111111100000010001
1111011111011101010010001
1100010101011100000010001
10000000E0001100000010001
10000000100011010100100001
101110111111110111011111
1111011110110101 11111001
111111111111111111111111